,Date,NestFlag,FalseCrawlFlag,total,state
15,5/13/2009,0,1,1,NC
20,5/14/2009,1,0,1,NC
23,5/15/2009,0,2,2,NC
28,5/16/2009,1,2,3,NC
33,5/17/2009,1,1,2,NC
44,5/19/2009,2,0,2,NC
52,5/20/2009,1,0,1,NC
59,5/21/2009,1,2,3,NC
66,5/22/2009,2,1,3,NC
75,5/23/2009,1,0,1,NC
91,5/25/2009,1,0,1,NC
99,5/26/2009,0,1,1,NC
108,5/27/2009,1,2,3,NC
117,5/28/2009,3,1,4,NC
126,5/29/2009,7,7,14,NC
136,5/30/2009,3,3,6,NC
145,5/31/2009,6,2,8,NC
162,6/1/2009,4,3,7,NC
261,6/2/2009,6,2,8,NC
360,6/3/2009,3,4,7,NC
378,6/4/2009,8,8,16,NC
387,6/5/2009,10,3,13,NC
396,6/6/2009,8,2,10,NC
405,6/7/2009,6,3,9,NC
414,6/8/2009,4,6,10,NC
423,6/9/2009,4,5,9,NC
171,6/10/2009,6,4,10,NC
180,6/11/2009,10,6,16,NC
189,6/12/2009,12,13,25,NC
198,6/13/2009,5,14,19,NC
207,6/14/2009,9,10,19,NC
216,6/15/2009,8,4,12,NC
225,6/16/2009,11,7,18,NC
234,6/17/2009,10,11,21,NC
243,6/18/2009,20,9,29,NC
252,6/19/2009,10,9,19,NC
270,6/20/2009,5,3,8,NC
279,6/21/2009,3,6,9,NC
288,6/22/2009,8,10,18,NC
297,6/23/2009,3,9,12,NC
306,6/24/2009,7,12,19,NC
315,6/25/2009,9,27,36,NC
324,6/26/2009,15,19,34,NC
333,6/27/2009,11,19,30,NC
342,6/28/2009,7,11,18,NC
351,6/29/2009,12,16,28,NC
369,6/30/2009,12,14,26,NC
432,7/1/2009,13,15,28,NC
529,7/2/2009,10,8,18,NC
618,7/3/2009,12,3,15,NC
643,7/4/2009,8,8,16,NC
652,7/5/2009,8,5,13,NC
661,7/6/2009,1,6,7,NC
670,7/7/2009,6,11,17,NC
679,7/8/2009,13,9,22,NC
688,7/9/2009,13,12,25,NC
441,7/10/2009,10,8,18,NC
450,7/11/2009,6,10,16,NC
459,7/12/2009,10,5,15,NC
468,7/13/2009,11,6,17,NC
477,7/14/2009,9,15,24,NC
486,7/15/2009,13,4,17,NC
495,7/16/2009,6,4,10,NC
504,7/17/2009,9,6,15,NC
513,7/18/2009,5,4,9,NC
521,7/19/2009,10,5,15,NC
538,7/20/2009,6,4,10,NC
546,7/21/2009,9,5,14,NC
554,7/22/2009,13,9,22,NC
562,7/23/2009,10,12,22,NC
570,7/24/2009,6,18,24,NC
578,7/25/2009,6,18,24,NC
586,7/26/2009,8,16,24,NC
594,7/27/2009,6,6,12,NC
602,7/28/2009,7,5,12,NC
610,7/29/2009,8,2,10,NC
627,7/30/2009,4,1,5,NC
635,7/31/2009,5,4,9,NC
697,8/1/2009,4,2,6,NC
779,8/2/2009,8,2,10,NC
835,8/3/2009,2,3,5,NC
849,8/4/2009,4,2,6,NC
857,8/5/2009,7,1,8,NC
865,8/6/2009,2,0,2,NC
873,8/7/2009,1,0,1,NC
881,8/8/2009,2,3,5,NC
889,8/9/2009,6,3,9,NC
705,8/10/2009,1,2,3,NC
713,8/11/2009,5,3,8,NC
721,8/12/2009,3,0,3,NC
742,8/15/2009,4,0,4,NC
750,8/16/2009,1,1,2,NC
757,8/17/2009,4,0,4,NC
772,8/19/2009,1,0,1,NC
787,8/20/2009,1,0,1,NC
801,8/22/2009,1,0,1,NC
810,8/24/2009,1,0,1,NC
824,8/27/2009,2,4,6,NC
828,8/28/2009,1,0,1,NC
845,8/31/2009,2,1,3,NC
903,9/3/2009,1,0,1,NC
899,9/15/2009,1,0,1,NC
902,9/17/2009,0,1,1,NC
2,10/7/2009,1,0,1,NC
67,5/22/2010,1,0,1,NC
76,5/23/2010,1,0,1,NC
84,5/24/2010,0,1,1,NC
92,5/25/2010,3,1,4,NC
100,5/26/2010,1,1,2,NC
109,5/27/2010,4,1,5,NC
118,5/28/2010,5,3,8,NC
127,5/29/2010,1,0,1,NC
137,5/30/2010,2,2,4,NC
146,5/31/2010,3,7,10,NC
163,6/1/2010,12,8,20,NC
262,6/2/2010,5,4,9,NC
361,6/3/2010,9,5,14,NC
379,6/4/2010,16,19,35,NC
388,6/5/2010,9,15,24,NC
397,6/6/2010,7,0,7,NC
406,6/7/2010,11,5,16,NC
415,6/8/2010,16,3,19,NC
424,6/9/2010,8,8,16,NC
172,6/10/2010,6,9,15,NC
181,6/11/2010,6,10,16,NC
190,6/12/2010,13,9,22,NC
199,6/13/2010,8,7,15,NC
208,6/14/2010,10,12,22,NC
217,6/15/2010,17,17,34,NC
226,6/16/2010,21,12,33,NC
235,6/17/2010,9,19,28,NC
244,6/18/2010,16,9,25,NC
253,6/19/2010,11,10,21,NC
271,6/20/2010,13,9,22,NC
280,6/21/2010,23,18,41,NC
289,6/22/2010,19,16,35,NC
298,6/23/2010,14,11,25,NC
307,6/24/2010,13,9,22,NC
316,6/25/2010,13,7,20,NC
325,6/26/2010,12,7,19,NC
334,6/27/2010,16,15,31,NC
343,6/28/2010,14,17,31,NC
352,6/29/2010,10,12,22,NC
370,6/30/2010,18,21,39,NC
433,7/1/2010,8,9,17,NC
530,7/2/2010,13,11,24,NC
619,7/3/2010,9,6,15,NC
644,7/4/2010,7,8,15,NC
653,7/5/2010,9,14,23,NC
662,7/6/2010,13,9,22,NC
671,7/7/2010,18,19,37,NC
680,7/8/2010,9,10,19,NC
689,7/9/2010,13,5,18,NC
442,7/10/2010,15,14,29,NC
451,7/11/2010,15,17,32,NC
460,7/12/2010,23,23,46,NC
469,7/13/2010,14,24,38,NC
478,7/14/2010,20,23,43,NC
487,7/15/2010,15,8,23,NC
496,7/16/2010,8,9,17,NC
505,7/17/2010,6,5,11,NC
514,7/18/2010,7,6,13,NC
522,7/19/2010,19,12,31,NC
539,7/20/2010,10,8,18,NC
547,7/21/2010,16,9,25,NC
555,7/22/2010,11,12,23,NC
563,7/23/2010,9,9,18,NC
571,7/24/2010,15,6,21,NC
579,7/25/2010,5,1,6,NC
587,7/26/2010,8,5,13,NC
595,7/27/2010,16,8,24,NC
603,7/28/2010,15,4,19,NC
611,7/29/2010,6,3,9,NC
628,7/30/2010,10,2,12,NC
636,7/31/2010,3,7,10,NC
698,8/1/2010,0,6,6,NC
780,8/2/2010,8,7,15,NC
836,8/3/2010,9,5,14,NC
850,8/4/2010,8,4,12,NC
858,8/5/2010,2,6,8,NC
866,8/6/2010,7,5,12,NC
874,8/7/2010,3,4,7,NC
882,8/8/2010,1,1,2,NC
890,8/9/2010,8,1,9,NC
706,8/10/2010,4,4,8,NC
714,8/11/2010,4,1,5,NC
722,8/12/2010,3,1,4,NC
729,8/13/2010,2,0,2,NC
736,8/14/2010,6,3,9,NC
743,8/15/2010,6,6,12,NC
751,8/16/2010,5,3,8,NC
758,8/17/2010,1,1,2,NC
765,8/18/2010,6,3,9,NC
773,8/19/2010,1,2,3,NC
788,8/20/2010,2,1,3,NC
795,8/21/2010,0,3,3,NC
802,8/22/2010,4,4,8,NC
806,8/23/2010,1,1,2,NC
811,8/24/2010,1,1,2,NC
815,8/25/2010,0,2,2,NC
820,8/26/2010,5,0,5,NC
829,8/28/2010,1,0,1,NC
833,8/29/2010,1,0,1,NC
843,8/30/2010,3,2,5,NC
846,8/31/2010,0,1,1,NC
895,9/1/2010,1,0,1,NC
907,9/5/2010,0,1,1,NC
909,9/6/2010,1,0,1,NC
913,9/8/2010,1,0,1,NC
898,9/14/2010,0,1,1,NC
3,4/27/2011,0,1,1,NC
156,5/7/2011,1,0,1,NC
6,5/10/2011,1,0,1,NC
24,5/15/2011,2,3,5,NC
29,5/16/2011,1,2,3,NC
34,5/17/2011,1,1,2,NC
39,5/18/2011,1,3,4,NC
45,5/19/2011,1,1,2,NC
53,5/20/2011,2,3,5,NC
60,5/21/2011,2,2,4,NC
68,5/22/2011,4,0,4,NC
77,5/23/2011,6,2,8,NC
85,5/24/2011,5,8,13,NC
93,5/25/2011,8,6,14,NC
101,5/26/2011,4,2,6,NC
110,5/27/2011,12,4,16,NC
119,5/28/2011,5,2,7,NC
128,5/29/2011,10,2,12,NC
138,5/30/2011,4,3,7,NC
147,5/31/2011,9,10,19,NC
164,6/1/2011,11,10,21,NC
263,6/2/2011,9,13,22,NC
362,6/3/2011,10,10,20,NC
380,6/4/2011,17,10,27,NC
389,6/5/2011,9,18,27,NC
398,6/6/2011,8,7,15,NC
407,6/7/2011,15,9,24,NC
416,6/8/2011,17,14,31,NC
425,6/9/2011,14,11,25,NC
173,6/10/2011,13,4,17,NC
182,6/11/2011,14,3,17,NC
191,6/12/2011,14,4,18,NC
200,6/13/2011,9,6,15,NC
209,6/14/2011,9,5,14,NC
218,6/15/2011,10,7,17,NC
227,6/16/2011,10,7,17,NC
236,6/17/2011,15,11,26,NC
245,6/18/2011,17,20,37,NC
254,6/19/2011,12,12,24,NC
272,6/20/2011,19,17,36,NC
281,6/21/2011,18,16,34,NC
290,6/22/2011,21,25,46,NC
299,6/23/2011,17,29,46,NC
308,6/24/2011,10,23,33,NC
317,6/25/2011,12,12,24,NC
326,6/26/2011,16,12,28,NC
335,6/27/2011,17,11,28,NC
344,6/28/2011,12,15,27,NC
353,6/29/2011,15,11,26,NC
371,6/30/2011,7,10,17,NC
434,7/1/2011,15,9,24,NC
531,7/2/2011,15,8,23,NC
620,7/3/2011,14,17,31,NC
645,7/4/2011,8,15,23,NC
654,7/5/2011,20,16,36,NC
663,7/6/2011,20,15,35,NC
672,7/7/2011,17,16,33,NC
681,7/8/2011,24,20,44,NC
690,7/9/2011,14,13,27,NC
443,7/10/2011,10,16,26,NC
452,7/11/2011,15,16,31,NC
461,7/12/2011,17,7,24,NC
470,7/13/2011,8,9,17,NC
479,7/14/2011,6,13,19,NC
488,7/15/2011,13,7,20,NC
497,7/16/2011,14,13,27,NC
506,7/17/2011,15,14,29,NC
515,7/18/2011,17,11,28,NC
523,7/19/2011,15,16,31,NC
540,7/20/2011,16,8,24,NC
548,7/21/2011,10,11,21,NC
556,7/22/2011,14,12,26,NC
564,7/23/2011,9,9,18,NC
572,7/24/2011,8,6,14,NC
580,7/25/2011,7,8,15,NC
588,7/26/2011,10,7,17,NC
596,7/27/2011,10,10,20,NC
604,7/28/2011,8,5,13,NC
612,7/29/2011,5,11,16,NC
629,7/30/2011,6,2,8,NC
637,7/31/2011,6,10,16,NC
699,8/1/2011,6,11,17,NC
781,8/2/2011,14,12,26,NC
837,8/3/2011,12,10,22,NC
851,8/4/2011,9,11,20,NC
859,8/5/2011,3,6,9,NC
867,8/6/2011,8,5,13,NC
875,8/7/2011,4,0,4,NC
883,8/8/2011,2,3,5,NC
891,8/9/2011,5,0,5,NC
707,8/10/2011,2,1,3,NC
715,8/11/2011,1,3,4,NC
723,8/12/2011,5,1,6,NC
730,8/13/2011,1,0,1,NC
737,8/14/2011,4,3,7,NC
744,8/15/2011,4,7,11,NC
752,8/16/2011,1,0,1,NC
759,8/17/2011,4,4,8,NC
766,8/18/2011,1,1,2,NC
774,8/19/2011,1,0,1,NC
789,8/20/2011,1,3,4,NC
796,8/21/2011,2,2,4,NC
807,8/23/2011,1,0,1,NC
896,9/1/2011,1,0,1,NC
4,4/27/2012,1,1,2,NC
153,5/4/2012,2,0,2,NC
7,5/10/2012,1,0,1,NC
9,5/11/2012,1,0,1,NC
11,5/12/2012,5,2,7,NC
16,5/13/2012,4,4,8,NC
21,5/14/2012,4,1,5,NC
30,5/16/2012,3,4,7,NC
35,5/17/2012,5,4,9,NC
40,5/18/2012,3,10,13,NC
46,5/19/2012,2,9,11,NC
54,5/20/2012,4,22,26,NC
61,5/21/2012,11,16,27,NC
69,5/22/2012,14,6,20,NC
78,5/23/2012,10,4,14,NC
86,5/24/2012,11,4,15,NC
94,5/25/2012,12,14,26,NC
102,5/26/2012,7,10,17,NC
111,5/27/2012,8,7,15,NC
120,5/28/2012,12,8,20,NC
129,5/29/2012,13,12,25,NC
139,5/30/2012,13,12,25,NC
148,5/31/2012,8,20,28,NC
165,6/1/2012,9,12,21,NC
264,6/2/2012,8,10,18,NC
363,6/3/2012,10,1,11,NC
381,6/4/2012,10,18,28,NC
390,6/5/2012,14,19,33,NC
399,6/6/2012,5,12,17,NC
408,6/7/2012,11,33,44,NC
417,6/8/2012,21,29,50,NC
426,6/9/2012,19,14,33,NC
174,6/10/2012,9,13,22,NC
183,6/11/2012,20,6,26,NC
192,6/12/2012,20,11,31,NC
201,6/13/2012,13,15,28,NC
210,6/14/2012,14,6,20,NC
219,6/15/2012,8,12,20,NC
228,6/16/2012,8,14,22,NC
237,6/17/2012,13,8,21,NC
246,6/18/2012,20,10,30,NC
255,6/19/2012,15,6,21,NC
273,6/20/2012,19,13,32,NC
282,6/21/2012,16,16,32,NC
291,6/22/2012,16,6,22,NC
300,6/23/2012,14,14,28,NC
309,6/24/2012,11,11,22,NC
318,6/25/2012,29,13,42,NC
327,6/26/2012,9,12,21,NC
336,6/27/2012,21,34,55,NC
345,6/28/2012,21,15,36,NC
354,6/29/2012,16,3,19,NC
372,6/30/2012,9,11,20,NC
435,7/1/2012,14,6,20,NC
532,7/2/2012,17,7,24,NC
621,7/3/2012,18,7,25,NC
646,7/4/2012,16,10,26,NC
655,7/5/2012,22,12,34,NC
664,7/6/2012,21,10,31,NC
673,7/7/2012,20,21,41,NC
682,7/8/2012,15,4,19,NC
691,7/9/2012,16,12,28,NC
444,7/10/2012,19,20,39,NC
453,7/11/2012,17,26,43,NC
462,7/12/2012,17,18,35,NC
471,7/13/2012,16,11,27,NC
480,7/14/2012,11,12,23,NC
489,7/15/2012,15,17,32,NC
498,7/16/2012,22,14,36,NC
507,7/17/2012,17,12,29,NC
516,7/18/2012,12,6,18,NC
524,7/19/2012,8,13,21,NC
541,7/20/2012,16,5,21,NC
549,7/21/2012,8,8,16,NC
557,7/22/2012,10,9,19,NC
565,7/23/2012,16,12,28,NC
573,7/24/2012,10,13,23,NC
581,7/25/2012,13,13,26,NC
589,7/26/2012,13,18,31,NC
597,7/27/2012,11,14,25,NC
605,7/28/2012,8,15,23,NC
613,7/29/2012,6,14,20,NC
630,7/30/2012,3,5,8,NC
638,7/31/2012,12,1,13,NC
700,8/1/2012,6,3,9,NC
782,8/2/2012,1,5,6,NC
838,8/3/2012,4,5,9,NC
852,8/4/2012,7,1,8,NC
860,8/5/2012,4,2,6,NC
868,8/6/2012,5,2,7,NC
876,8/7/2012,6,7,13,NC
884,8/8/2012,7,2,9,NC
892,8/9/2012,7,4,11,NC
708,8/10/2012,2,0,2,NC
716,8/11/2012,2,0,2,NC
724,8/12/2012,1,1,2,NC
731,8/13/2012,1,2,3,NC
738,8/14/2012,4,1,5,NC
745,8/15/2012,1,1,2,NC
753,8/16/2012,1,1,2,NC
760,8/17/2012,1,2,3,NC
767,8/18/2012,1,3,4,NC
775,8/19/2012,2,0,2,NC
790,8/20/2012,1,3,4,NC
797,8/21/2012,1,0,1,NC
821,8/26/2012,1,0,1,NC
825,8/27/2012,1,0,1,NC
830,8/28/2012,0,2,2,NC
12,5/12/2013,1,0,1,NC
17,5/13/2013,0,1,1,NC
25,5/15/2013,0,2,2,NC
47,5/19/2013,1,1,2,NC
62,5/21/2013,1,1,2,NC
70,5/22/2013,2,1,3,NC
79,5/23/2013,3,0,3,NC
103,5/26/2013,2,6,8,NC
112,5/27/2013,2,4,6,NC
121,5/28/2013,5,9,14,NC
130,5/29/2013,7,2,9,NC
140,5/30/2013,5,4,9,NC
149,5/31/2013,6,8,14,NC
166,6/1/2013,4,8,12,NC
265,6/2/2013,16,13,29,NC
364,6/3/2013,10,10,20,NC
382,6/4/2013,8,12,20,NC
391,6/5/2013,14,9,23,NC
400,6/6/2013,17,10,27,NC
409,6/7/2013,1,5,6,NC
418,6/8/2013,6,13,19,NC
427,6/9/2013,14,18,32,NC
175,6/10/2013,24,15,39,NC
184,6/11/2013,13,17,30,NC
193,6/12/2013,15,15,30,NC
202,6/13/2013,18,17,35,NC
211,6/14/2013,19,9,28,NC
220,6/15/2013,17,20,37,NC
229,6/16/2013,23,12,35,NC
238,6/17/2013,16,18,34,NC
247,6/18/2013,22,18,40,NC
256,6/19/2013,13,16,29,NC
274,6/20/2013,20,31,51,NC
283,6/21/2013,13,16,29,NC
292,6/22/2013,13,14,27,NC
301,6/23/2013,15,31,46,NC
310,6/24/2013,13,18,31,NC
319,6/25/2013,17,29,46,NC
328,6/26/2013,17,14,31,NC
337,6/27/2013,25,24,49,NC
346,6/28/2013,18,16,34,NC
355,6/29/2013,15,8,23,NC
373,6/30/2013,11,14,25,NC
436,7/1/2013,22,19,41,NC
533,7/2/2013,26,51,77,NC
622,7/3/2013,27,25,52,NC
647,7/4/2013,17,15,32,NC
656,7/5/2013,20,14,34,NC
665,7/6/2013,19,13,32,NC
674,7/7/2013,19,18,37,NC
683,7/8/2013,22,24,46,NC
692,7/9/2013,19,17,36,NC
445,7/10/2013,23,22,45,NC
454,7/11/2013,23,21,44,NC
463,7/12/2013,26,19,45,NC
472,7/13/2013,16,20,36,NC
481,7/14/2013,25,21,46,NC
490,7/15/2013,21,43,64,NC
499,7/16/2013,27,17,44,NC
508,7/17/2013,13,16,29,NC
517,7/18/2013,15,7,22,NC
525,7/19/2013,18,15,33,NC
542,7/20/2013,19,11,30,NC
550,7/21/2013,20,17,37,NC
558,7/22/2013,16,13,29,NC
566,7/23/2013,9,10,19,NC
574,7/24/2013,26,20,46,NC
582,7/25/2013,22,8,30,NC
590,7/26/2013,12,13,25,NC
598,7/27/2013,17,10,27,NC
606,7/28/2013,17,15,32,NC
614,7/29/2013,22,27,49,NC
631,7/30/2013,13,13,26,NC
639,7/31/2013,15,9,24,NC
701,8/1/2013,14,10,24,NC
783,8/2/2013,12,13,25,NC
839,8/3/2013,10,5,15,NC
853,8/4/2013,11,4,15,NC
861,8/5/2013,12,14,26,NC
869,8/6/2013,10,8,18,NC
877,8/7/2013,5,2,7,NC
885,8/8/2013,9,3,12,NC
893,8/9/2013,11,4,15,NC
709,8/10/2013,6,10,16,NC
717,8/11/2013,9,14,23,NC
725,8/12/2013,13,13,26,NC
732,8/13/2013,7,6,13,NC
739,8/14/2013,2,5,7,NC
746,8/15/2013,2,5,7,NC
754,8/16/2013,4,15,19,NC
761,8/17/2013,8,14,22,NC
768,8/18/2013,5,3,8,NC
776,8/19/2013,4,2,6,NC
791,8/20/2013,2,1,3,NC
798,8/21/2013,3,2,5,NC
803,8/22/2013,3,2,5,NC
808,8/23/2013,5,3,8,NC
812,8/24/2013,1,0,1,NC
816,8/25/2013,1,0,1,NC
822,8/26/2013,4,1,5,NC
826,8/27/2013,1,2,3,NC
844,8/30/2013,1,1,2,NC
904,9/3/2013,0,3,3,NC
905,9/4/2013,3,2,5,NC
911,9/7/2013,1,1,2,NC
914,9/8/2013,1,0,1,NC
897,9/11/2013,1,0,1,NC
901,9/16/2013,1,0,1,NC
1,10/3/2013,1,0,1,NC
157,5/7/2014,0,2,2,NC
159,5/9/2014,1,0,1,NC
48,5/19/2014,0,2,2,NC
55,5/20/2014,1,1,2,NC
71,5/22/2014,1,0,1,NC
80,5/23/2014,0,1,1,NC
87,5/24/2014,2,0,2,NC
95,5/25/2014,2,0,2,NC
104,5/26/2014,2,2,4,NC
113,5/27/2014,1,2,3,NC
122,5/28/2014,1,4,5,NC
131,5/29/2014,1,5,6,NC
141,5/30/2014,4,5,9,NC
150,5/31/2014,2,10,12,NC
167,6/1/2014,4,6,10,NC
266,6/2/2014,4,3,7,NC
365,6/3/2014,3,6,9,NC
383,6/4/2014,11,6,17,NC
392,6/5/2014,8,9,17,NC
401,6/6/2014,5,4,9,NC
410,6/7/2014,2,6,8,NC
419,6/8/2014,5,4,9,NC
428,6/9/2014,8,5,13,NC
176,6/10/2014,7,5,12,NC
185,6/11/2014,4,4,8,NC
194,6/12/2014,4,6,10,NC
203,6/13/2014,1,8,9,NC
212,6/14/2014,6,8,14,NC
221,6/15/2014,7,13,20,NC
230,6/16/2014,10,16,26,NC
239,6/17/2014,12,7,19,NC
248,6/18/2014,14,8,22,NC
257,6/19/2014,5,9,14,NC
275,6/20/2014,11,15,26,NC
284,6/21/2014,6,5,11,NC
293,6/22/2014,8,11,19,NC
302,6/23/2014,15,6,21,NC
311,6/24/2014,13,9,22,NC
320,6/25/2014,8,13,21,NC
329,6/26/2014,5,9,14,NC
338,6/27/2014,7,6,13,NC
347,6/28/2014,8,12,20,NC
356,6/29/2014,10,9,19,NC
374,6/30/2014,16,17,33,NC
437,7/1/2014,11,14,25,NC
534,7/2/2014,13,11,24,NC
623,7/3/2014,7,8,15,NC
648,7/4/2014,3,4,7,NC
657,7/5/2014,5,5,10,NC
666,7/6/2014,9,10,19,NC
675,7/7/2014,13,16,29,NC
684,7/8/2014,11,7,18,NC
693,7/9/2014,2,3,5,NC
446,7/10/2014,3,15,18,NC
455,7/11/2014,9,9,18,NC
464,7/12/2014,8,3,11,NC
473,7/13/2014,16,11,27,NC
482,7/14/2014,10,16,26,NC
491,7/15/2014,7,7,14,NC
500,7/16/2014,10,7,17,NC
509,7/17/2014,7,14,21,NC
518,7/18/2014,10,6,16,NC
526,7/19/2014,3,7,10,NC
543,7/20/2014,8,11,19,NC
551,7/21/2014,9,4,13,NC
559,7/22/2014,3,8,11,NC
567,7/23/2014,10,10,20,NC
575,7/24/2014,7,5,12,NC
583,7/25/2014,4,6,10,NC
591,7/26/2014,11,5,16,NC
599,7/27/2014,8,7,15,NC
607,7/28/2014,9,12,21,NC
615,7/29/2014,6,2,8,NC
632,7/30/2014,7,5,12,NC
640,7/31/2014,5,4,9,NC
702,8/1/2014,6,0,6,NC
784,8/2/2014,3,2,5,NC
840,8/3/2014,2,2,4,NC
854,8/4/2014,1,10,11,NC
862,8/5/2014,2,5,7,NC
870,8/6/2014,6,8,14,NC
878,8/7/2014,1,6,7,NC
886,8/8/2014,2,7,9,NC
894,8/9/2014,7,3,10,NC
710,8/10/2014,1,6,7,NC
718,8/11/2014,4,7,11,NC
726,8/12/2014,4,3,7,NC
733,8/13/2014,5,2,7,NC
747,8/15/2014,5,2,7,NC
762,8/17/2014,0,3,3,NC
769,8/18/2014,2,1,3,NC
792,8/20/2014,3,0,3,NC
799,8/21/2014,2,0,2,NC
804,8/22/2014,1,1,2,NC
813,8/24/2014,0,1,1,NC
817,8/25/2014,1,0,1,NC
827,8/27/2014,2,5,7,NC
831,8/28/2014,1,1,2,NC
847,8/31/2014,0,1,1,NC
908,9/5/2014,1,0,1,NC
910,9/6/2014,1,1,2,NC
154,5/6/2015,0,3,3,NC
158,5/8/2015,2,1,3,NC
13,5/12/2015,0,0,0,NC
18,5/13/2015,3,1,4,NC
31,5/16/2015,1,2,3,NC
36,5/17/2015,2,0,2,NC
41,5/18/2015,3,0,3,NC
49,5/19/2015,2,4,6,NC
56,5/20/2015,5,7,12,NC
63,5/21/2015,3,1,4,NC
72,5/22/2015,3,4,7,NC
81,5/23/2015,3,5,8,NC
88,5/24/2015,7,14,21,NC
96,5/25/2015,16,13,29,NC
105,5/26/2015,12,14,26,NC
114,5/27/2015,16,8,24,NC
123,5/28/2015,15,5,20,NC
132,5/29/2015,10,10,20,NC
142,5/30/2015,14,10,24,NC
151,5/31/2015,25,11,36,NC
168,6/1/2015,15,13,28,NC
267,6/2/2015,12,12,24,NC
366,6/3/2015,18,12,30,NC
384,6/4/2015,2,8,10,NC
393,6/5/2015,17,15,32,NC
402,6/6/2015,15,16,31,NC
411,6/7/2015,17,8,25,NC
420,6/8/2015,16,31,47,NC
429,6/9/2015,22,20,42,NC
177,6/10/2015,19,34,53,NC
186,6/11/2015,24,23,47,NC
195,6/12/2015,16,22,38,NC
204,6/13/2015,20,20,40,NC
213,6/14/2015,27,24,51,NC
222,6/15/2015,19,21,40,NC
231,6/16/2015,16,10,26,NC
240,6/17/2015,21,29,50,NC
249,6/18/2015,19,34,53,NC
258,6/19/2015,24,34,58,NC
276,6/20/2015,16,15,31,NC
285,6/21/2015,22,43,65,NC
294,6/22/2015,30,37,67,NC
303,6/23/2015,23,25,48,NC
312,6/24/2015,19,35,54,NC
321,6/25/2015,25,23,48,NC
330,6/26/2015,23,24,47,NC
339,6/27/2015,17,22,39,NC
348,6/28/2015,16,9,25,NC
357,6/29/2015,17,24,41,NC
375,6/30/2015,18,16,34,NC
438,7/1/2015,27,10,37,NC
535,7/2/2015,20,22,42,NC
624,7/3/2015,18,26,44,NC
649,7/4/2015,18,26,44,NC
658,7/5/2015,25,25,50,NC
667,7/6/2015,27,14,41,NC
676,7/7/2015,17,18,35,NC
685,7/8/2015,21,23,44,NC
694,7/9/2015,19,16,35,NC
447,7/10/2015,18,21,39,NC
456,7/11/2015,18,25,43,NC
465,7/12/2015,11,12,23,NC
474,7/13/2015,18,13,31,NC
483,7/14/2015,16,20,36,NC
492,7/15/2015,14,27,41,NC
501,7/16/2015,20,24,44,NC
510,7/17/2015,14,18,32,NC
519,7/18/2015,16,17,33,NC
527,7/19/2015,18,18,36,NC
544,7/20/2015,25,31,56,NC
552,7/21/2015,13,23,36,NC
560,7/22/2015,21,30,51,NC
568,7/23/2015,12,11,23,NC
576,7/24/2015,8,11,19,NC
584,7/25/2015,4,5,9,NC
592,7/26/2015,8,7,15,NC
600,7/27/2015,13,10,23,NC
608,7/28/2015,10,8,18,NC
616,7/29/2015,7,8,15,NC
633,7/30/2015,6,8,14,NC
641,7/31/2015,6,5,11,NC
703,8/1/2015,8,4,12,NC
785,8/2/2015,9,8,17,NC
841,8/3/2015,6,5,11,NC
855,8/4/2015,8,17,25,NC
863,8/5/2015,5,11,16,NC
871,8/6/2015,5,7,12,NC
879,8/7/2015,2,4,6,NC
887,8/8/2015,4,5,9,NC
711,8/10/2015,2,2,4,NC
719,8/11/2015,4,1,5,NC
727,8/12/2015,2,1,3,NC
734,8/13/2015,3,4,7,NC
740,8/14/2015,3,2,5,NC
748,8/15/2015,0,3,3,NC
755,8/16/2015,1,3,4,NC
763,8/17/2015,3,2,5,NC
770,8/18/2015,3,1,4,NC
777,8/19/2015,1,1,2,NC
793,8/20/2015,1,3,4,NC
805,8/22/2015,1,0,1,NC
814,8/24/2015,1,2,3,NC
818,8/25/2015,1,1,2,NC
823,8/26/2015,1,0,1,NC
832,8/28/2015,1,0,1,NC
906,9/4/2015,1,1,2,NC
915,9/8/2015,1,0,1,NC
900,9/15/2015,1,0,1,NC
160,5/9/2016,0,1,1,NC
8,5/10/2016,0,1,1,NC
10,5/11/2016,2,2,4,NC
19,5/13/2016,2,0,2,NC
22,5/14/2016,0,2,2,NC
26,5/15/2016,4,3,7,NC
32,5/16/2016,1,2,3,NC
37,5/17/2016,2,3,5,NC
42,5/18/2016,5,2,7,NC
50,5/19/2016,1,3,4,NC
57,5/20/2016,3,4,7,NC
64,5/21/2016,2,12,14,NC
73,5/22/2016,1,9,10,NC
82,5/23/2016,5,11,16,NC
89,5/24/2016,4,8,12,NC
97,5/25/2016,12,6,18,NC
106,5/26/2016,17,23,40,NC
115,5/27/2016,10,11,21,NC
124,5/28/2016,8,7,15,NC
133,5/29/2016,12,4,16,NC
143,5/30/2016,16,16,32,NC
152,5/31/2016,19,10,29,NC
169,6/1/2016,13,11,24,NC
268,6/2/2016,12,12,24,NC
367,6/3/2016,15,16,31,NC
385,6/4/2016,12,10,22,NC
394,6/5/2016,21,11,32,NC
403,6/6/2016,24,22,46,NC
412,6/7/2016,9,19,28,NC
421,6/8/2016,21,26,47,NC
430,6/9/2016,23,26,49,NC
178,6/10/2016,20,24,44,NC
187,6/11/2016,24,10,34,NC
196,6/12/2016,21,32,53,NC
205,6/13/2016,25,9,34,NC
214,6/14/2016,21,23,44,NC
223,6/15/2016,27,15,42,NC
232,6/16/2016,12,10,22,NC
241,6/17/2016,19,17,36,NC
250,6/18/2016,12,8,20,NC
259,6/19/2016,24,29,53,NC
277,6/20/2016,28,26,54,NC
286,6/21/2016,25,18,43,NC
295,6/22/2016,22,9,31,NC
304,6/23/2016,20,11,31,NC
313,6/24/2016,19,22,41,NC
322,6/25/2016,28,16,44,NC
331,6/26/2016,26,43,69,NC
340,6/27/2016,31,32,63,NC
349,6/28/2016,27,34,61,NC
358,6/29/2016,21,24,45,NC
376,6/30/2016,19,17,36,NC
439,7/1/2016,32,19,51,NC
536,7/2/2016,33,32,65,NC
625,7/3/2016,20,13,33,NC
650,7/4/2016,21,20,41,NC
659,7/5/2016,33,34,67,NC
668,7/6/2016,26,42,68,NC
677,7/7/2016,20,43,63,NC
686,7/8/2016,25,27,52,NC
695,7/9/2016,21,29,50,NC
448,7/10/2016,19,30,49,NC
457,7/11/2016,15,26,41,NC
466,7/12/2016,28,43,71,NC
475,7/13/2016,31,18,49,NC
484,7/14/2016,28,33,61,NC
493,7/15/2016,22,28,50,NC
502,7/16/2016,11,15,26,NC
511,7/17/2016,11,17,28,NC
